0 0 0 0 0 0 0 0 0 0 0 0 0 0 0 0 0 0 0 0 0 0 0 0 0 0 0 0 0 0
0 8 8 8 8 8 7 8 8 8 8 8 8 8 0 8 8 8 8 8 8 8 7 8 8 8 8 8 8 0
0 8 0 0 0 0 8 0 0 0 0 0 0 8 0 8 0 0 0 0 0 0 8 0 0 0 0 0 8 0
0 8 0 0 0 0 8 0 0 0 0 0 0 8 0 8 0 0 0 0 0 0 8 0 0 0 0 0 8 0
0 7 8 8 8 8 7 8 8 8 8 8 8 7 8 7 8 8 8 8 8 8 7 8 8 8 8 8 7 0
0 8 0 0 0 0 8 0 8 0 0 0 0 0 0 0 0 0 0 0 8 0 8 0 0 0 0 0 8 0
0 8 8 8 8 8 7 0 8 8 8 8 8 8 0 8 8 8 8 8 8 0 7 8 8 8 8 8 8 0
0 8 0 0 0 0 8 0 0 0 0 0 0 8 0 8 0 0 0 0 0 0 8 0 0 0 0 0 8 0
0 8 0 0 0 0 8 0 8 8 8 8 8 6 8 6 8 8 8 8 8 0 8 0 0 0 0 0 8 0
0 8 0 0 0 0 8 0 8 0 0 0 0 0 0 0 0 0 0 0 8 0 8 0 0 0 0 0 8 0
0 8 0 0 0 0 8 8 7 0 0 0 0 0 0 0 0 0 0 0 7 8 8 0 0 0 0 0 8 0
0 8 0 0 0 0 8 0 8 0 0 0 0 0 0 0 0 0 0 0 8 0 8 0 0 0 0 0 8 0
0 8 0 0 0 0 8 0 8 0 0 0 0 0 0 0 0 0 0 0 8 0 8 0 0 0 0 0 8 0
0 8 0 0 0 0 8 0 7 8 8 8 8 8 8 8 8 8 8 8 7 0 8 0 0 0 0 0 8 0
0 8 0 0 0 0 8 0 8 0 0 0 0 0 0 0 0 0 0 0 8 0 8 0 0 0 0 0 8 0
0 8 8 8 8 8 7 8 7 8 8 8 8 8 0 8 8 8 8 8 7 8 7 8 8 8 8 8 8 0
0 8 0 0 0 0 8 0 0 0 0 0 0 8 0 8 0 0 0 0 0 0 8 0 0 0 0 0 8 0
0 7 8 8 8 8 7 8 7 8 8 8 8 6 8 6 8 8 8 8 7 8 7 0 8 8 8 8 7 0
0 8 0 0 0 0 8 0 8 0 0 0 0 0 0 0 0 0 0 0 8 0 8 0 8 0 0 0 8 0
0 7 8 8 8 8 8 0 8 8 8 8 8 8 0 8 8 8 8 8 8 0 8 8 7 8 8 8 7 0
0 8 0 0 0 0 0 0 0 0 0 0 0 8 0 8 0 0 0 0 0 0 0 0 0 0 0 0 8 0
0 8 8 8 8 8 8 8 8 8 8 8 8 7 8 7 8 8 8 8 8 8 8 8 8 8 8 8 8 0
0 0 0 0 0 0 0 0 0 0 0 0 0 0 0 0 0 0 0 0 0 0 0 0 0 0 0 0 0 0
























